# 0 = Pathway, 1 = Wall, 2<Entity-Number> = Entity: Entity.BaseOnTypeWithNumbers, 3 = RED Light, 4 = GREEN Light, 5 = Escape Portal, 6 = Player Spawn
1,1,1,1,1,1,1,1,1,1,1,1,1,1,1,1,1,1,1,1,1,1,1,1,1,1,1
1,6,1,1,1,0,21,0,0,0,0,1,0,0,5,1,0,0,0,0,0,0,0,0,0,0,1
1,0,1,0,0,0,0,0,1,0,0,3,1,1,0,1,0,0,0,1,0,0,0,0,0,0,1
1,0,0,0,1,0,1,0,0,1,0,1,1,1,0,0,0,1,0,0,0,1,0,1,1,1,1
1,1,1,1,1,1,0,1,0,1,0,0,0,3,1,1,1,0,1,1,0,1,0,0,0,0,1
1,1,0,0,0,1,0,1,0,0,0,1,0,0,0,0,0,0,0,0,0,0,0,1,1,1,1
1,1,4,4,4,1,4,1,3,4,1,4,1,1,1,1,1,0,0,1,1,1,1,1,1,1,1
1,1,1,1,1,1,1,1,1,1,1,1,1,1,1,1,1,1,1,1,1,1,1,1,1,1,1